Live-Birth,15-19,20-24,25-29,30-34,35-39,40-44,45-49,Total
1,95,129,44,20,7,5,0,300
2,20,87,61,34,11,1,1,215
3,2,52,86,37,17,2,0,196
4,0,18,47,39,27,10,0,141
5,0,3,29,24,22,5,1,84
6,0,2,18,24,17,3,0,64
7,0,0,2,9,13,3,1,28
8,0,0,1,17,14,7,0,39
9,0,0,0,3,4,4,0,11
10,0,0,0,0,3,3,0,6